ANGRY	AE NG G R IY
ARE	AA R
ARE(2)	ER
DONE	D AH N
EMERGENCY	IH M ER JH AH N S IY
EMERGENCY(2)	IY M ER JH AH N S IY
HAPPY	HH AE P IY
HELP	HH EH L P
MAYBE	M EY B IY
NO	N OW
PAINTING	P EY N T IH NG
PAINTING(2)	P EY N IH NG
RELAXED	R IH L AE K S T
RELAXED(2)	R IY L AE K S T
SAD	S AE D
STOP	S T AA P
WHAT	W AH T
WHAT(2)	HH W AH T
YES	Y EH S
YOU	Y UW
